35 42 28 0 21 14 49 7 
50 15 29 43 0 8 22 36 
51 16 30 0 9 37 23 44 
45 52 31 17 38 24 10 0 
18 11 25 46 32 53 0 39 
26 0 54 19 47 33 12 40 
41 48 34 13 27 20 0 55 
42 19 1 13 35 49 28 21 
36 43 22 1 20 29 7 50 
1 37 44 30 14 51 23 8 
24 45 31 9 1 38 15 52 
39 25 16 53 46 10 32 1 
40 26 33 17 1 47 54 11 
55 48 12 27 41 18 1 34 
2 21 42 17 12 28 49 35 
2 50 43 13 22 29 36 18 
23 19 7 51 37 30 44 2 
45 24 31 8 2 20 52 38 
14 32 46 53 25 2 39 9 
10 47 15 26 40 2 33 54 
48 55 11 34 41 16 2 27 
21 11 28 35 3 15 49 42 
43 36 29 50 3 12 22 16 
44 17 37 51 30 23 3 13 
38 31 45 24 18 7 52 3 
19 46 8 39 25 32 3 53 
26 47 9 20 54 3 33 40 
14 41 48 10 34 3 27 55 
28 49 21 20 42 4 10 35 
29 36 43 4 22 14 11 50 
30 51 15 23 44 37 4 12 
13 24 45 4 52 38 31 16 
17 46 7 39 25 4 53 32 
18 8 40 4 33 47 54 26 
19 55 41 27 9 4 34 48 
21 49 18 28 42 5 9 35 
50 19 22 5 29 43 10 36 
11 30 20 5 51 37 44 23 
24 45 12 31 14 38 5 52 
13 15 53 5 39 32 46 25 
33 5 47 26 40 54 7 16 
41 34 48 17 8 5 55 27 
6 21 35 42 28 49 16 8 
6 17 50 9 22 43 29 36 
37 6 44 23 51 10 18 30 
24 38 52 6 11 31 19 45 
53 20 39 25 32 46 6 12 
13 47 54 40 26 14 33 6 
34 27 6 55 48 7 41 15 
1 6 56 3 2 5 4 0 
56 13 11 12 8 9 7 10 
56 15 19 20 16 18 17 14 
22 21 23 24 26 27 56 25 
31 29 32 33 34 28 56 30 
41 56 38 39 36 35 37 40 
43 42 48 56 44 46 47 45 
52 49 50 56 54 51 55 53 
