35 42 0 28 7 49 21 14 
50 29 36 8 22 0 43 15 
16 51 37 0 30 9 44 23 
10 52 45 0 38 24 17 31 
11 39 53 0 18 32 25 46 
47 0 54 12 33 26 19 40 
20 34 41 48 55 27 0 13 
42 35 49 19 1 21 28 13 
43 22 36 7 29 50 20 1 
30 23 44 1 14 51 8 37 
15 52 24 45 1 31 38 9 
46 25 1 16 53 32 10 39 
11 26 33 17 47 40 1 54 
41 48 12 34 55 1 27 18 
35 17 42 21 12 2 28 49 
18 22 2 43 29 50 13 36 
30 2 19 44 23 37 7 51 
52 31 45 38 8 2 20 24 
25 32 9 14 53 39 46 2 
40 47 33 2 15 54 26 10 
11 55 48 34 2 41 16 27 
11 21 49 15 3 35 42 28 
12 50 3 16 36 22 43 29 
44 51 13 23 3 37 30 17 
31 45 38 24 3 7 18 52 
46 39 3 25 32 53 8 19 
26 54 3 9 47 40 33 20 
27 48 10 3 55 14 34 41 
10 49 42 28 21 35 4 20 
22 50 29 4 43 36 11 14 
23 15 4 30 44 37 12 51 
4 52 31 13 16 45 38 24 
17 39 25 53 32 46 4 7 
8 18 47 54 4 40 26 33 
34 48 27 9 41 55 19 4 
5 28 35 21 18 9 42 49 
22 5 29 36 10 19 50 43 
51 5 11 30 37 23 20 44 
24 45 31 38 52 12 14 5 
5 53 46 32 15 25 13 39 
26 5 7 47 16 33 54 40 
17 41 55 5 27 8 48 34 
16 49 6 8 35 42 28 21 
50 22 6 17 43 9 29 36 
30 18 37 6 10 23 44 51 
31 24 19 45 52 6 38 11 
6 12 32 53 39 20 25 46 
33 13 6 40 47 54 14 26 
55 34 6 41 48 7 15 27 
4 0 1 3 56 5 6 2 
9 10 8 56 11 12 13 7 
19 15 14 18 20 16 17 56 
56 27 23 26 24 25 21 22 
33 29 31 32 28 56 34 30 
39 40 56 41 38 36 35 37 
45 47 42 43 56 44 46 48 
51 52 56 50 55 54 49 53 
