49 0 14 7 42 28 35 21 
0 15 8 22 36 50 43 29 
37 0 23 9 30 44 51 16 
24 38 0 17 45 52 10 31 
11 32 0 18 25 39 46 53 
33 0 19 40 26 47 12 54 
48 34 13 0 41 55 20 27 
13 1 49 35 21 42 28 19 
29 43 20 7 36 50 22 1 
1 37 14 8 23 30 44 51 
31 38 1 24 9 45 52 15 
25 39 46 53 32 10 16 1 
11 40 26 54 47 33 1 17 
18 55 1 27 48 41 34 12 
49 21 42 28 35 2 17 12 
50 2 43 13 36 22 18 29 
23 30 44 2 51 19 37 7 
20 24 8 31 52 45 38 2 
39 25 2 14 32 46 9 53 
2 10 47 40 26 15 33 54 
11 2 48 55 34 16 27 41 
35 21 15 3 42 11 49 28 
50 22 16 36 29 3 12 43 
37 44 13 17 23 51 30 3 
38 45 24 7 52 3 31 18 
46 19 3 53 39 25 32 8 
40 33 54 26 3 9 20 47 
48 34 14 41 3 55 10 27 
10 35 4 21 20 28 42 49 
4 50 22 36 11 14 29 43 
51 30 23 37 4 12 44 15 
31 38 52 16 45 4 24 13 
25 17 7 39 46 4 53 32 
4 47 33 18 8 40 26 54 
41 9 55 34 27 48 4 19 
21 42 35 49 28 9 18 5 
50 22 19 36 10 43 29 5 
51 37 23 44 5 11 20 30 
5 24 52 45 12 14 38 31 
53 25 15 5 13 39 32 46 
33 7 26 5 47 54 40 16 
41 27 5 34 8 55 48 17 
35 16 8 21 49 28 42 6 
6 43 17 50 9 22 29 36 
10 51 23 37 44 30 18 6 
6 19 24 11 45 52 31 38 
46 6 20 39 12 25 32 53 
14 40 26 6 33 13 54 47 
41 55 34 15 48 7 6 27 
56 3 2 0 1 4 5 6 
7 9 56 12 8 10 11 13 
18 17 14 15 56 16 19 20 
22 23 21 26 24 25 56 27 
29 33 28 30 34 56 31 32 
37 39 40 41 56 36 38 35 
42 47 43 46 45 56 44 48 
49 55 53 52 51 54 56 50 
